******************************
**          ************** * *
**** **********     ****** * *
**** ********** ********** * *
*    ********** B********* * *
**** ********** ********** * *
*    ******                * *
**** ****** *********** **** *
**** ******             **** *
**** ****** ****** ********* *
**** ****** ****** ********* *
****        ****** ********* *
*********** ****** ********* *
*********** ****** ********* *
***********             **** *
***         **************** *
*** ************************ *
*** ***********              *
*** *********** *****  ***** *
***             ***** ****** *
****** ******** ***** ****** *
****** ******** ***** ****** *
****** ******** ***** ****** *
****                     *** *
********** ********** ****** *
********** ********** ****** *
**********            ****** *
********** ****************  *
A              ***************
******************************